100.ts
.t..........t.........t.t.............t........................t.......t....................t...t.t.
...........t................................t..........................t............t...............
..........t........................t......................t.tt.......tt................t............
...........t......t.................t.....t......t...t........t....t...t........t..t.....t.....t.t.t
...............t.....t...t...................t..............t..........................t......t.....
t..........t.t.......................................t..............................................
...t................t.......t..t..t..t....t...............................t.............t...........
....t....t............t......t.......t.....................t...t....t.t.t................t........tt
...................................t............t..t......................t.........................
.................t..........t...........t...............................t...........................
........t.........................t.................t.............................t....t.t..t....t..
......t.................t.........t.......t........t.....t.........t..........t.t..t...t.t...t......
.................................t.................t........t...t.......................t...........
............................t...........................t............tt.......t....................t
..........t......t...............t...t.......t...................t..t......t...t....................
...........t................t....t...t...............................t.t....t.................t....t
...t...........................t...t......................t............................t......t.....
....t....t......t.....t......t.............t......t....t......t....t..tt....t..............tt.......
.......t..........................tt...t...................t.......t...................t............
.......t.....ttt...t.....t............t...t.t................................t....t.................
.t........................t................................t..................................t.....
.................................t...tt...t..............t.....t.........t........t.....tt......t...
.......................................t.t.....t...t................t.....................t...t.....
.........t.....t..........t......t.........t............t........t..............t.............tt....
...........................................................t....t....t...............t...t..........
...............t...t...............t...............................t.................t..............
........tt.t...t.....t..........................t.....t............................t.....t..........
..................t.tt.tt......t....t........t.tt..................t....t...........................
t......................t.t.t....................t...................................t...............
.....t..t.........t...........t.........................................t......t.....t........t....t
.......................t...............t............................................................
............tt............t..t...................t....t..........................t..................
....t......t..........t.......................t...................................t.................
.......t...............................t....................t.........t.......................t.....
......................................t...................................t.t...tt..................
t...............t...................................................t.........................t....t
t...t...........t.......t....................t......................t...............................
.......t.t......................t.t.................tt....t..................t......................
.............t...............t.t...................t........t............t........t....t............
t...........t..t.................t.....t..tt.....t......t.....t......t..............................
..................t.........t..t...............t......................t.............................
...........................t..t..............................t..........t..............t.....t.t..t.
.............t....t.................t......tt.............t.............t...........................
...t.......t....t........t....t......................tt...t...................t....t................
....tt......t...t.....t....t......t.t..t.....t.........t...................t.t.......t...........t..
..............t...............t.........................t.t.....................t.........t..tt...t.
......t..t.......................t............................................t....................t
t.............t...t...........t.........t.............................t...t...t........t............
.........t....t......t.........................................t.............tt....t..t.............
..............tt.............................................t....t............t....................
.........t.......................t.....................t..............................t.............
t.........................t.t.....t........t.................t............t...t..............t.t....
.......t....t.......t.............tt....t.................t..................t....t.............t...
...........................t...t........t.................t.....................t...................
.......t......t.........t...........t.....................t...t..........tt........................t
............t........t...................t...........................t.....t........................
............................t...t.....t......t...................t............tt.......t.........t..
................t........................t............t...................................t..t......
.......t........t...........................................................................t.......
....................t........................t...t.........t......t...........t...t...........t...t.
.....................t.t...................t.....tt......t.........t...........tt...................
........t....................t....t.........t.........t...................................t...t..t..
........................t...............t....tt................t.........................t..........
.....t...............t.......t..t.......................tt.................t........t.....t.........
..............tt....................t...t.t.........................t...............................
t......tt.....t...t..t................................................................t.............
t.................................t.t.......................t..t....................................
.....................t....................t..............t...........t............t...........t..t..
.........t..............t....t.....................t.......t..t...................t....t............
......................t...................................................t....t...............t....
t....t..t...............t.....t..................t....................................t.............
...........t................................t..t..................................t.................
....ttt.t...t...................t.......t.....t..................t.......t..t.t...........t.........
...........tt..................................t........tt.t.............t........t.........t.......
............................t..............tt....................t...............t.......t.tt.......
.......................t.....t...t.t........t..............t................................t.......
t........t......................................t...t....t........t.................t..t............
.......t.........t..................t..............t...................t...t...t.....t..t........t..
.........t....t.....t..t......................t.....t...............................................
...t.....tt...............t...............t...t.t.................................t.....t..........t
..t.........t................t..t......t............................t......t..............t.........
..........................t............t..........t..........................t..tt..................
......t....t...........t.......t........................................................t...........
................t....t......................t.............t...........t...............tt............
.........t...t.t.......tt.............................................t.......t.........t...........
..............t........t...........t..........................t...t........tt.t..........t..........
...............t.........t.............t.........tt...............t..............................t..
.....t......t.........t.......t..t....t............t..................t.............................
..t......t...t...t...t..........................t.....t......t......t.t.......t.t...................
......t...................t....t..t..........t..t..t...........................................tt..t
.........................t.......t...................t....t...t..................t..ttt.............
..t.......t..t...........t........t........t....t.........t.....t...t...............t...............
..........t.......t.............................................t.t........................t....tt..
......................................................t.....................................t..t....
..................t.........................t.....................................tt...t.t.t........
...................................t.....t..tt.............t.......t.........tt.......t....t........
.......t........t..............t.........t.............t..........................................t.
...................t....t...t......................t.t..........t.....t........t.............t.t....
................t........................................t......t...............t......t............
.....................t............t......t......t..................................t............t...
