10.ts
........t.
.t........
..........
..........
..........
..........
......t...
..........
.....t....
......t...
